demand - требовать
miserable - жалкий, убогий
be relieved - happy that something unpleasant has not happened or has ended
it's a shame - ето позор(мне стыдно)
work in shifts - работать посменно
excitedly - взволновано
shone - посветить
they didn't have to be supervised - их не нужно было контролировать
supervise - контроль
she frowned - она нахмурилась
foolish - глупый
same traits - те же черты
speculating - размышлять
endless - бесконечный
keep track - следить
declare - объявить
after being told - после того как было сказано
this ensures - это гарантирует
derived - полученный
despite - не смотря на, вопреки
won't experience - не испытаете
conversation - розмова, бесіда
outstanding - выдающийся

доповідач - speaker, reporter, presenter 
підозри - concerns, suspicion, allegation

fit into - вписатись в колектив, соответствовать
The new employee seems to fit into the company culture very well.
He had a hard time fitting into the new school

To what extent do you think - Как вы думаете, в какой степени

distinguish - различать, отличать
I guess - наверное
i guess you - я думаю, вы
implying - подразумевая
bla bla
merge
go to rebase